017 017 017 017 017 017 017 017 017 017 017 017 017 017 017 017 017 017 017 017 017 017 017 017 017 017 017 017 017 017 017 017 017 017 017 017 017 017 017 017 017 017 017 017 017 017 017 017 017 017
017 017 017 017 017 017 017 017 017 017 017 017 017 017 017 017 017 017 017 017 017 017 017 017 017 017 017 017 017 017 017 017 017 017 017 017 017 017 017 017 017 017 017 017 017 017 017 017 017 017
017 017 017 017 017 017 017 017 017 017 017 017 017 017 017 017 017 017 017 017 017 017 017 032 019 019 019 019 019 019 019 019 019 019 019 019 019 033 017 017 017 017 017 017 017 017 017 017 017 017
017 017 017 017 017 017 017 017 017 017 017 017 017 017 017 017 017 017 017 032 019 019 019 024 001 001 043 001 001 038 001 001 036 001 001 001 001 023 019 019 033 017 017 017 017 017 017 017 017 017
017 017 017 017 017 017 017 017 017 017 017 017 017 017 017 032 019 019 019 024 001 001 001 043 001 001 001 001 044 001 001 043 001 001 001 043 001 001 001 001 023 019 019 019 033 017 017 017 017 017
017 017 017 017 017 017 017 017 017 017 017 017 017 032 019 024 038 043 001 001 001 043 038 001 001 001 036 001 001 001 039 001 001 001 001 043 001 036 001 001 001 001 001 001 023 019 019 019 019 019
017 017 017 017 017 017 017 017 017 017 017 032 019 024 039 001 001 036 001 001 039 001 001 001 001 003 002 002 002 002 002 002 002 002 004 001 001 044 001 001 043 001 001 001 001 001 043 001 001 000
017 017 017 017 017 017 017 017 017 017 032 024 001 039 038 036 039 001 001 001 044 001 001 003 002 014 010 010 010 010 010 010 010 010 013 002 002 004 039 043 038 001 001 001 003 002 002 002 004 000
017 017 017 017 017 017 017 017 032 019 024 001 038 036 043 001 036 043 001 001 001 003 002 014 010 010 010 010 010 010 010 010 010 011 010 010 010 013 002 004 001 001 003 002 014 016 007 007 009 000
017 017 017 017 017 017 017 032 024 001 001 001 001 001 038 001 001 001 001 001 001 006 010 010 010 010 010 016 007 007 015 010 010 010 010 010 010 010 010 013 002 002 014 016 007 009 001 036 001 000
017 017 017 017 017 017 032 024 001 001 001 043 001 001 001 001 001 001 001 001 003 014 010 011 010 010 010 005 044 045 006 010 010 010 010 010 010 010 016 007 007 007 007 009 001 001 001 022 018 018
017 017 017 017 017 017 020 001 001 001 038 044 001 039 001 043 001 001 001 001 006 010 010 010 010 010 010 005 046 047 006 010 010 010 010 010 010 010 005 001 001 001 039 001 001 001 022 031 017 017
017 017 017 017 017 032 024 001 036 001 043 001 001 001 043 001 001 001 001 001 006 010 010 010 010 010 010 013 002 002 014 010 010 010 010 011 010 010 005 001 001 043 044 001 001 022 031 017 017 017
017 017 017 017 017 020 001 043 001 039 001 043 036 001 001 038 001 001 001 043 008 015 010 010 010 010 010 010 010 010 010 010 010 010 010 010 010 016 009 001 001 001 043 038 001 021 017 017 017 017
017 017 017 017 017 034 026 026 026 026 026 026 029 001 036 001 044 001 001 001 001 006 010 010 010 010 010 010 010 010 010 010 010 010 010 010 010 005 001 001 001 001 001 001 022 031 017 017 017 017
017 017 017 017 017 020 001 001 001 001 001 001 028 026 026 026 029 001 043 001 001 008 015 010 010 010 010 010 010 010 010 010 010 010 010 010 016 009 001 001 001 043 036 001 021 017 017 017 017 017
017 017 017 017 032 024 001 001 001 001 001 001 001 001 001 039 027 001 038 001 001 001 008 015 010 010 010 010 010 010 010 010 010 010 016 007 009 001 039 001 001 001 001 001 021 017 017 017 017 017
017 017 017 017 020 001 001 001 039 001 001 001 001 001 001 001 028 029 001 001 043 001 001 007 015 010 010 010 010 010 010 016 007 007 009 001 001 038 001 001 001 001 001 001 021 017 017 017 017 017
017 017 017 017 020 001 001 001 001 001 043 001 039 001 001 001 001 028 026 026 029 001 001 001 008 007 015 016 007 007 007 009 001 001 001 001 001 044 001 001 001 001 001 001 021 017 017 017 017 017
017 017 017 032 024 001 043 001 001 043 001 001 038 001 001 044 001 001 001 001 028 029 001 001 001 001 006 005 001 001 001 001 001 001 001 001 043 001 001 001 043 001 001 001 023 033 017 017 017 017
017 017 017 020 001 001 001 044 043 001 001 001 001 001 001 043 001 001 001 043 039 027 043 036 001 001 006 005 001 039 001 001 001 001 001 001 001 001 001 001 001 038 001 001 036 021 017 017 017 017
017 017 017 020 001 001 001 001 001 001 001 001 001 043 001 001 001 001 001 001 001 027 001 044 038 043 006 005 001 001 001 001 038 036 001 001 001 001 001 001 001 001 043 001 001 023 033 017 017 017
017 017 017 020 001 036 001 001 001 039 001 044 043 038 001 001 043 001 044 001 001 028 029 001 043 036 006 005 001 001 044 043 001 001 001 043 001 001 001 043 001 036 001 036 001 001 021 017 017 017
017 017 017 020 001 001 001 043 036 001 001 001 038 001 001 001 001 001 043 001 001 001 027 001 001 001 006 005 038 001 001 036 001 001 039 001 001 001 001 001 001 039 001 038 001 001 021 017 017 017
017 017 017 020 001 044 001 001 001 001 001 001 001 001 001 043 001 001 001 001 044 001 028 026 026 026 040 041 026 026 026 026 026 026 026 029 001 001 001 001 001 001 043 001 039 001 023 033 017 017
017 017 017 020 001 043 038 001 001 001 001 001 001 001 044 001 038 001 001 001 001 001 043 001 001 001 006 005 001 001 001 001 001 001 001 028 026 026 026 026 029 038 001 001 001 001 001 021 017 017
017 017 017 020 001 001 001 001 001 001 001 001 001 001 001 001 001 001 001 001 001 043 001 001 001 001 006 005 001 001 001 001 043 001 036 001 001 001 001 001 028 026 026 026 029 001 001 021 017 017
017 017 017 020 001 039 001 001 001 001 001 043 039 001 001 043 001 036 001 038 001 001 001 039 001 001 006 005 036 001 038 001 039 001 001 001 001 038 001 001 001 001 001 001 028 026 026 035 017 017
017 017 017 030 025 001 001 038 044 001 001 001 001 001 036 001 001 001 001 001 001 001 001 001 001 001 006 005 001 001 044 001 001 043 001 039 001 043 001 043 001 001 038 039 001 001 001 021 017 017
017 017 017 017 020 001 001 043 001 001 001 001 001 001 001 001 001 001 001 001 001 036 001 001 044 001 008 009 001 043 001 001 038 001 044 001 001 001 036 044 001 001 001 001 039 043 001 021 017 017
017 017 017 017 020 001 001 001 001 001 043 001 043 001 001 043 001 001 001 001 043 001 001 001 001 043 001 001 001 001 001 001 001 001 001 001 001 043 001 001 001 043 036 001 043 001 022 031 017 017
017 017 017 017 030 025 001 001 001 001 001 043 044 001 001 001 039 001 001 001 001 001 001 001 001 001 001 039 001 001 001 044 001 036 001 001 001 001 001 001 001 001 039 001 001 001 021 017 017 017
017 017 017 017 017 020 001 001 043 001 001 001 001 001 001 001 001 043 036 001 001 001 001 043 001 001 001 001 001 001 001 001 001 001 001 001 001 001 001 001 001 038 001 001 001 022 031 017 017 017
017 017 017 017 017 030 025 001 001 001 036 001 036 001 001 001 044 001 001 001 001 038 001 001 001 036 001 001 001 043 001 001 001 001 001 001 038 001 001 043 001 001 001 001 022 031 017 017 017 017
017 017 017 017 017 017 030 025 001 001 001 001 001 043 039 001 001 001 001 001 001 001 039 001 001 001 001 044 001 001 001 001 036 001 001 044 001 036 001 001 039 001 001 022 031 017 017 017 017 017
017 017 017 017 017 017 017 030 025 001 044 038 001 036 001 001 001 038 001 001 001 001 001 001 001 001 043 001 001 001 043 001 001 001 001 001 001 001 038 001 001 001 022 031 017 017 017 017 017 017
017 017 017 017 017 017 017 017 020 001 043 039 001 001 001 001 001 001 001 001 001 001 001 001 001 001 001 001 001 001 001 001 001 001 001 001 001 001 001 001 001 022 031 017 017 017 017 017 017 017
017 017 017 017 017 017 017 017 030 025 001 001 001 001 001 001 036 001 001 001 001 001 001 001 001 001 038 036 001 001 001 001 001 043 001 001 001 001 039 001 001 021 017 017 017 017 017 017 017 017
017 017 017 017 017 017 017 017 017 030 025 001 001 039 001 001 001 001 044 043 001 001 001 022 018 025 001 001 039 001 001 001 001 001 001 001 001 043 001 001 001 021 017 017 017 017 017 017 017 017
017 017 017 017 017 017 017 017 017 017 020 001 001 001 001 001 001 001 001 001 001 001 001 021 017 030 025 001 044 001 038 001 039 001 001 038 001 001 001 001 022 031 017 017 017 017 017 017 017 017
017 017 017 017 017 017 017 017 017 017 030 025 001 001 044 001 043 001 039 001 001 001 022 031 017 017 030 025 001 001 001 001 043 001 001 001 039 001 001 022 031 017 017 017 017 017 017 017 017 017
017 017 017 017 017 017 017 017 017 017 017 030 025 001 036 001 001 001 001 001 001 001 021 017 017 017 017 020 001 001 001 001 044 039 036 001 001 001 022 031 017 017 017 017 017 017 017 017 017 017
017 017 017 017 017 017 017 017 017 017 017 017 030 025 001 038 001 036 044 001 001 022 031 017 017 017 017 020 001 001 001 001 038 001 001 001 001 001 021 017 017 017 017 017 017 017 017 017 017 017
017 017 017 017 017 017 017 017 017 017 017 017 017 020 001 036 001 001 001 001 001 021 017 017 017 017 017 030 025 001 001 001 001 001 043 001 001 022 031 017 017 017 017 017 017 017 017 017 017 017
017 017 017 017 017 017 017 017 017 017 017 017 017 030 025 001 001 001 001 036 022 031 017 017 017 017 017 017 030 025 001 001 001 001 001 001 022 031 017 017 017 017 017 017 017 017 017 017 017 017
017 017 017 017 017 017 017 017 017 017 017 017 017 017 030 018 018 018 018 018 031 017 017 017 017 017 017 017 017 030 025 001 001 001 001 022 031 017 017 017 017 017 017 017 017 017 017 017 017 017
017 017 017 017 017 017 017 017 017 017 017 017 017 017 017 017 017 017 017 017 017 017 017 017 017 017 017 017 017 017 030 018 018 018 018 031 017 017 017 017 017 017 017 017 017 017 017 017 017 017
017 017 017 017 017 017 017 017 017 017 017 017 017 017 017 017 017 017 017 017 017 017 017 017 017 017 017 017 017 017 017 017 017 017 017 017 017 017 017 017 017 017 017 017 017 017 017 017 017 017
017 017 017 017 017 017 017 017 017 017 017 017 017 017 017 017 017 017 017 017 017 017 017 017 017 017 017 017 017 017 017 017 017 017 017 017 017 017 017 017 017 017 017 017 017 017 017 017 017 017
017 017 017 017 017 017 017 017 017 017 017 017 017 017 017 017 017 017 017 017 017 017 017 017 017 017 017 017 017 017 017 017 017 017 017 017 017 017 017 017 017 017 017 017 017 017 017 017 017 017