066 066 066 066 066 066 066 066 066 066 066 066 066 066 066 066 066 066 066 066 066 066 066 066 066 066 066 066 066 066 066 066 066 066 066 066 066 066 066 066 066 066 066 066 066 066 066 066 066 066
066 066 066 066 066 066 066 066 066 066 066 066 066 078 068 068 068 068 068 068 068 068 068 068 068 068 068 068 068 068 068 068 068 068 077 066 066 066 066 066 066 066 066 066 066 066 066 066 066 066
066 066 066 066 066 078 068 068 068 068 068 068 068 074 048 048 048 048 048 048 048 048 048 048 080 048 048 048 048 048 048 048 048 048 073 068 068 068 068 077 066 066 066 066 066 066 066 066 066 066
068 068 068 068 068 074 048 048 048 082 048 048 048 048 048 048 048 048 048 048 048 048 048 048 048 048 048 048 048 048 087 080 048 048 048 048 048 048 048 073 068 068 077 066 066 066 066 066 066 066
048 048 048 080 048 048 048 081 048 048 079 048 048 079 048 048 048 048 048 048 048 048 048 079 048 048 048 048 048 048 048 048 082 048 048 082 087 048 080 048 048 048 073 077 066 066 066 066 066 066
049 049 049 049 049 049 049 049 049 053 048 048 080 082 048 048 048 048 048 080 048 087 048 048 048 054 049 049 049 049 049 053 048 048 079 048 082 048 048 048 048 048 048 073 077 066 066 066 066 066
050 050 050 050 050 050 050 050 060 059 049 049 053 048 048 048 081 079 082 048 054 049 049 049 049 058 061 050 050 050 060 059 049 053 048 048 048 048 081 048 079 048 048 048 073 077 066 066 066 066
048 048 048 048 048 082 048 048 055 050 050 060 059 049 049 053 048 054 049 049 058 061 050 050 050 050 056 048 048 048 055 050 060 059 049 053 048 048 048 048 048 082 081 048 048 069 066 066 066 066
048 087 048 080 048 048 048 079 048 048 048 055 050 050 060 059 049 058 061 050 050 056 048 048 048 082 048 048 048 048 048 048 055 050 060 059 049 049 053 048 087 048 080 048 048 073 077 066 066 066
067 067 067 071 048 048 048 048 048 079 048 048 048 048 051 083 084 052 048 048 048 048 079 048 048 048 048 048 048 048 048 048 048 048 055 050 050 060 059 049 053 048 048 048 048 048 069 066 066 066
066 066 066 076 071 048 048 087 048 048 048 048 080 048 051 085 086 052 048 048 048 048 048 048 048 087 048 048 048 048 048 048 048 048 048 048 048 055 050 060 052 048 048 048 048 048 069 066 066 066
066 066 066 066 070 048 048 082 048 080 048 048 048 048 051 057 057 052 048 082 048 081 048 048 048 048 048 082 048 048 048 082 079 048 048 048 048 048 048 051 052 048 048 087 080 048 069 066 066 066
066 066 066 066 070 048 048 048 048 048 048 048 048 048 051 057 061 056 048 079 048 082 048 048 048 048 081 048 048 082 048 048 048 048 048 048 048 048 048 051 052 048 048 081 048 048 069 066 066 066
066 066 066 078 074 081 048 048 048 048 087 048 048 048 051 057 052 048 048 087 048 048 048 048 072 067 067 067 067 071 048 048 048 081 048 082 048 048 048 055 056 048 048 079 048 048 069 066 066 066
066 066 066 070 048 048 048 048 048 048 048 048 048 048 051 057 052 048 048 048 048 072 067 067 075 066 066 066 066 076 071 048 048 087 082 048 048 048 048 048 048 048 048 048 048 048 073 077 066 066
066 066 066 070 048 048 048 048 048 048 048 048 048 054 058 061 056 048 048 048 072 075 066 066 066 066 066 066 066 066 076 071 048 048 079 048 048 048 048 048 048 048 048 082 048 048 048 069 066 066
066 066 066 070 048 048 048 080 048 048 082 048 048 051 061 056 048 048 048 072 075 066 066 066 066 066 066 066 066 066 066 076 071 048 048 080 082 048 048 048 048 048 048 048 048 081 048 069 066 066
066 066 066 070 048 048 048 048 048 048 048 048 048 051 052 048 048 072 067 075 066 066 066 066 066 066 066 066 066 066 066 066 076 071 048 048 048 048 048 048 048 048 048 048 048 048 048 069 066 066
066 066 078 074 048 080 048 048 048 048 048 048 048 051 052 048 072 075 066 066 066 066 066 066 066 066 066 066 066 066 066 066 066 070 048 048 048 048 048 048 048 048 048 048 048 048 048 069 066 066
066 066 070 048 048 048 048 080 048 048 082 048 048 051 052 048 069 066 066 066 066 066 066 066 066 066 066 066 066 066 066 066 066 070 048 048 048 048 048 048 048 048 079 048 048 048 048 069 066 066
066 066 070 048 048 048 048 048 048 048 048 048 048 051 052 048 069 066 066 066 066 066 066 066 066 066 066 066 066 066 066 066 066 070 048 048 081 048 082 048 048 048 048 080 087 048 048 069 066 066
066 066 070 048 048 048 048 048 087 048 048 048 054 058 052 048 069 066 066 066 066 066 066 066 066 066 066 066 066 066 066 066 078 074 048 048 048 048 048 048 048 087 048 048 048 048 048 069 066 066
066 066 070 048 048 048 048 082 048 082 048 048 051 061 056 048 069 066 066 066 066 066 066 066 066 066 066 066 066 066 066 078 074 048 048 048 048 048 048 048 048 048 048 048 079 048 048 069 066 066
066 066 070 048 079 048 082 048 048 048 048 048 051 052 048 048 073 077 066 066 066 066 066 066 066 066 066 066 066 066 078 074 080 048 048 048 081 048 048 048 048 048 048 082 048 048 048 069 066 066
066 066 070 048 048 080 087 048 082 048 048 048 051 052 048 048 048 073 077 066 066 066 066 066 066 066 066 078 068 068 074 048 081 048 048 048 048 048 048 080 048 048 048 048 048 081 048 069 066 066
066 066 070 048 048 081 048 048 048 048 048 048 051 052 048 080 048 048 073 068 077 066 066 066 078 068 068 074 048 048 048 080 048 079 048 048 048 048 048 081 079 048 048 048 048 082 048 069 066 066
066 066 070 048 048 080 082 048 048 048 048 048 051 052 048 048 048 048 048 048 073 068 068 068 074 048 048 048 081 048 048 048 048 048 048 048 048 048 048 048 048 048 048 048 048 048 072 075 066 066
066 066 070 048 079 048 048 082 048 048 080 048 051 052 048 048 048 048 048 048 048 048 048 048 048 048 048 048 048 048 048 048 048 048 080 048 048 048 048 048 048 048 048 048 048 081 069 066 066 066
066 066 070 048 048 048 080 079 048 048 048 048 055 056 048 048 080 048 048 048 048 048 048 048 048 048 048 080 048 048 048 048 087 048 048 048 079 087 048 048 048 081 079 080 079 082 069 066 066 066
066 066 070 048 048 048 048 048 048 048 048 048 048 048 048 048 04087 8 048 048 048 048 048 087 048 081 048 048 048 048 048 048 048 048 048 048 048 048 048 048 080 048 048 048 048 048 048 069 066 066 066
066 066 076 071 048 048 048 048 048 048 048 048 048 048 048 048 048 048 048 080 087 048 048 048 048 048 048 048 048 048 048 048 048 048 048 048 048 048 048 048 080 048 079 080 082 072 075 066 066 066
066 066 066 070 081 048 048 048 048 048 048 082 048 082 048 048 048 048 048 048 048 048 048 048 048 048 048 048 048 048 048 048 048 048 048 079 048 048 048 048 048 048 082 048 048 069 066 066 066 066
066 066 066 070 048 048 087 048 048 087 048 048 048 048 048 048 048 048 048 048 048 079 048 048 048 048 048 048 048 048 048 087 048 048 048 048 048 048 048 048 048 079 080 082 072 075 066 066 066 066
066 066 066 070 048 048 082 048 081 048 048 048 048 048 048 048 048 048 048 048 048 048 048 048 048 048 048 048 048 048 048 048 048 048 048 048 048 048 048 048 048 048 048 072 075 066 066 066 066 066
066 066 066 070 048 048 048 048 048 048 048 048 048 048 048 048 048 048 048 048 048 048 048 048 087 048 048 048 048 048 048 048 048 048 048 048 048 048 087 080 048 048 072 075 066 066 066 066 066 066
066 066 066 076 071 048 048 048 048 048 048 048 048 048 048 087 048 048 048 048 080 048 048 048 048 087 048 048 048 048 048 048 048 048 087 048 048 048 048 048 048 072 075 066 066 066 066 066 066 066
066 066 066 066 070 048 048 048 048 082 048 048 048 048 048 048 048 048 048 081 048 048 048 048 048 048 048 048 080 048 048 048 048 048 048 048 081 048 048 048 048 073 077 066 066 066 066 066 066 066
066 066 066 066 070 081 048 048 087 048 048 048 048 087 048 048 079 048 048 048 048 048 048 048 048 048 048 048 081 048 048 048 048 080 048 048 048 048 048 087 048 048 073 077 066 066 066 066 066 066
066 066 066 066 076 071 048 081 048 048 048 048 048 048 048 048 048 048 048 048 048 079 048 080 048 048 048 048 048 048 048 048 081 072 067 067 071 048 048 048 048 048 048 073 077 066 066 066 066 066
066 066 066 066 066 076 071 048 048 048 048 048 082 048 082 048 081 048 082 048 048 048 048 048 048 048 048 072 067 067 067 067 067 075 066 066 076 071 048 048 048 048 048 081 073 068 068 068 077 066
066 066 066 066 066 066 076 067 071 048 048 048 048 081 048 048 048 048 048 048 048 048 048 072 067 067 067 075 066 066 066 066 066 066 066 066 066 076 067 071 080 048 048 048 048 088 048 048 069 066
066 066 066 066 066 066 066 066 076 067 071 048 048 048 048 081 048 048 080 048 072 067 067 075 066 066 066 066 066 066 066 066 066 066 066 066 066 066 066 076 071 048 048 048 048 088 048 089 069 066
066 066 066 066 066 066 066 066 066 066 076 067 067 067 067 067 067 067 067 067 075 066 066 066 066 066 066 066 066 066 066 066 066 066 066 066 066 066 066 066 076 071 048 082 048 088 048 048 069 066
066 066 066 066 066 066 066 066 066 066 066 066 066 066 066 066 066 066 066 066 066 066 066 066 066 066 066 066 066 066 066 066 066 066 066 066 066 066 066 066 066 076 067 067 067 067 067 067 075 066
066 066 066 066 066 066 066 066 066 066 066 066 066 066 066 066 066 066 066 066 066 066 066 066 066 066 066 066 066 066 066 066 066 066 066 066 066 066 066 066 066 066 066 066 066 066 066 066 066 066
066 066 066 066 066 066 066 066 066 066 066 066 066 066 066 066 066 066 066 066 066 066 066 066 066 066 066 066 066 066 066 066 066 066 066 066 066 066 066 066 066 066 066 066 066 066 066 066 066 066
066 066 066 066 066 066 066 066 066 066 066 066 066 066 066 066 066 066 066 066 066 066 066 066 066 066 066 066 066 066 066 066 066 066 066 066 066 066 066 066 066 066 066 066 066 066 066 066 066 066
066 066 066 066 066 066 066 066 066 066 066 066 066 066 066 066 066 066 066 066 066 066 066 066 066 066 066 066 066 066 066 066 066 066 066 066 066 066 066 066 066 066 066 066 066 066 066 066 066 066
066 066 066 066 066 066 066 066 066 066 066 066 066 066 066 066 066 066 066 066 066 066 066 066 066 066 066 066 066 066 066 066 066 066 066 066 066 066 066 066 066 066 066 066 066 066 066 066 066 066
066 066 066 066 066 066 066 066 066 066 066 066 066 066 066 066 066 066 066 066 066 066 066 066 066 066 066 066 066 066 066 066 066 066 066 066 066 066 066 066 066 066 066 066 066 066 066 066 066 066